#########
#####   #
#       #
# # #$.## 
#    $.#  
# # #$.#  
#       # 
#####@  # 
    ####  3
